NO ./textures/wall_1.xpm
SO ./textures/wall_2.xpm
WE ./textures/wall_3.xpm
EA ./textures/wall_4.xpm
F 20,20,20
C 200,200,200

1111111111111
10000000000N1
1000000000001
1000000000001
1111111111111