NO  textures/N.xpm
SO  textures/SP_HOT2.xpm
WE  textures/SP_HOT3.xpm
EA  textures/W.xpm
F 0,0,0
C 0,0,0

        1111111111111111111111111
        100000000110000000000001
        1011000001110000000000001
        100100000000000000000001
11111111101100000111000000000001
100000000011000001110111111111111
11110111111111011100000010001
11110111111111011101010010001
11000000110101011100000010001
10000000000000000000000000001 
10000000000000001101000000001
110000011101010111110110N0111
11110111 1110101 101111010001
11111111 1111111 111111111111
