NO  textures/east_wall.xpm
SO  textures/east_wall.xpm
WE  textures/east_wall.xpm
EA  textures/east_wall.xpm
F 220,100,0
C 225,30,0

        1111111111111111111111111
        1000000000110000000000001
        1011000001110000000000001
        100100000000000000000001
11111111101100000111000000000001
100000000011000001110111111111111
11110111111111011100000010001
11110111111111011101010010001
11000000110101011100000010001
10000000000000000000000000001 
10000000000000001101000000001
110000011101010111110110N0111
11110111 1110101 101111010001
11111111 1111111 111111111111
