NO textures/wall.xpm
SO textures/wall.xpm
WE textures/wall.xpm
EA textures/north_wall.xpm
F 220,100,0
C 225,30,0

11111111
10000001
10N0000111111111111
1000000000000000001
1111111111111111111