NO textures/wall.xpm
SO textures/wall.xpm
WE textures/wall.xpm
EA textures/north_wall.xpm
F 220,100,0
C 225,30,0

    1111111111111111111111111
    1000000000110000000000001
    1011000001110000000000001
    1001000000000000000000001
    1111111110110000011100001
11110000001100000111011111111
11110111111111011100000010001
11110111111111011101010010001
11000000110101011100000010001
10000000000000001100000010001
10000000000000001101010010001
110000011101010111110111100111
1111N111 1110101 101111010001
11111111 1111111 111111111111